NO texture/wall3.xpm
SO texture/wall2-2.xpm
EA texture/wall2-3.xpm
WE texture/wall3-1.xpm

F   0,0,102
C   124,0,125

           1111111111111111111111111
           1000000000110000000000001
           1011000001110000000000001
           1001000000000000000000001
111111111111011000000110000000000001
100000000011000001110111111111111111
11110111111111011100000000001  
11110111111111011101010010001
11000000110101011100000010001
10000000000000001100000010001
10000000000000001101010N010001
110000011101010111110111100111
11110111 1110101 101111010001
11111111 1111111111111111111